محترم	POS
كريم	POS
غفور	POS
عبيط	NEG
وسخه	NEG
طموح	POS
جامد	POS
عظيم	POS
مغرور	NEG
عسل	POS
مسليني	POS
خطير	NEG
كلب	NEG
معرص	NEG
اخر تعيس	NEG
مش هتموت	POS
بضان	NEG
قذر	NEG
جامده	POS
مبدع	POS
جدعه	POS
واطي	NEG
رائع	POS
تواب	POS
جحلوط	NEG
محبوب	POS
تاني	Neutral
متخلف	NEG
غبي	NEG
ذكي	POS
رب	POS
مثقف	POS
ودود	POS
جميل	POS
جبار	POS
فتوكه	Neutral
امنجي	NEG
خائن	NEG
خبؤ	NEG
مريضه	NEG
اهبل	NEG
فقيع	NEG
تاعب نفسه	POS
قادر	POS
رومانسي طموح	POS
وسخ	NEG
عسليه	POS
عادي	Neutral
كويسه	POS
جاهل	NEG
كويس	POS
محترمه	POS
قدير	POS
جامدين	POS
وراه سر	Neutral
نعجه	NEG
عميل	NEG
دماغها	Neutral
غلابه	POS
زباله	NEG
كان محترم	POS
حاجته نضيفه	POS
متحجر	NEG
عقدت ناس	NEG
مزه	POS
نكسجي حمار	NEG
اشطه	POS
عبيطه	NEG
معجبه	POS
غريب	NEG
قدوس	POS
حاجه حلوه	POS
عبد الروس	NEG
حر	POS
فاضل بعيد	Neutral
رغاي	NEG
نجس	NEG
شكلها جدعه	POS
اسطوره	POS
ابن وسخه	NEG
نعيمي	NEG
قطري	NEG
خول	NEG
سخيف	NEG
سخنه	NEG
اجبن خلق الله	NEG
متناك	NEG
فلول	NEG
مدفيني	POS
شايف نفسه	NEG
مؤلم	NEG
منحط	NEG
مقرف	NEG
جدعه و	POS
شرموطه	NEG
عمتي مريضه	NEG
مستفز	NEG
الله	POS
برنس	POS
قويه	POS
بنتش كلب	NEG
جبان	NEG
أعمى القلب والنظر	NEG
راعبكم	NEG
حشره	NEG
ايممممانك	POS
ضحكته جامده	POS
بيسامحك	POS
ممل	NEG
خروف	NEG
صوص	Neutral
عزيز	POS
شيعي	NEG
حقير	NEG
سيء	NEG
صدامي	NEG
مركز	POS
زانيه	NEG
بن المتناكه	NEG
مسليه	POS
هذي غيره	NEG
صحي	POS
كان عظيم	POS
كلب تروتسكي	NEG
بحبها	POS
بهتم بيه	POS
cool	POS
ابن الحيوان	NEG
داهيه	NEG
حاقد	NEG
متربي	POS
تتكلميش	Neutral
كتكوت	POS
مش صحي	NEG
ممحونه	NEG
اصلا واضح	Neutral
عادل	POS
وطني	POS
المخانيث	NEG
كبري قصر النيل	Neutral
مباريات	Neutral
مسالم	POS
حريمه	Neutral
استغلالي	NEG
ذوق	POS
سميع الدعاء	POS
طيبة جداا	POS
تكفيخي	NEG
انيقه	POS
ضعيفه	NEG
ابن المتناكه	NEG
كتوم	POS
متململ	NEG
غالي علي	POS
وشها جامد	POS
طيب	POS
محارب	POS
ابن موزه	NEG
مفتريه	NEG
اتبهدل	NEG
ابن الوسخه	NEG
طعس تفووووو عليك	NEG
باع	NEG
ناصريه	NEG
ابن الزانيه	NEG
الوسخه	NEG
وبتقولي	Neutral
بالفيس مستواهن	Neutral
كريه	NEG
بن اﻷحبة	NEG
بيمثل قطاع	Neutral
حليم	POS
خطر	NEG
مضحك	POS
ساقط	NEG
صح	POS
لبيه	Neutral
رخمه	NEG
عبد السيسي	NEG
مش لذيذ	NEG
لطيف احبك	POS
قمر	POS
مش هيقعد	NEG
الزواني	NEG
متعب	NEG
رموطه	NEG
ترّف	POS
امعه	NEG
ممكن	Neutral
قاتل	NEG
ضلالي	NEG
لطيف	POS
اخر	Neutral
وسخة	NEG
اناني	NEG
حنينه	POS
فلانه عشان	Neutral
سياسي	Neutral
وليه ناقصه	NEG
ارهابي اتفوووه عليكم	NEG
مشكوك فيه	NEG
بتوع السيسي المعرص	NEG
بشري محترم	POS
فقيه بلنتي لنصصصصصر	Neutral
بني قديم	NEG
ام كس مدود	NEG
دماغه عالية	POS
حاجه	Neutral
هايف	NEG
بتاعت نمر	NEG
شمال	NEG
بتضرب	NEG
بلد	Neutral
اتشحور	NEG
قرده	NEG
صوفي	NEG
زنديق	NEG
حاد	NEG
نذل	NEG
حاجه هييييييح	POS
اللي اسمك اسكندر	Neutral
برجوازي متسلق	NEG
طفران	NEG
جدعان	POS
متكبر	NEG
جاموسه	NEG
نسخ	NEG
لذيذه	POS
الناس ثوره	Neutral
مميز	POS
مُتعب	NEG
طلعتي كور"واطيا"	NEG
بيعجبنى	POS
مسكين	NEG
بفكر راقي	POS
نضيف	POS
نفيس غالي	POS
والله بشتم	NEG
ابن اكبر واطي	NEG
ناجح	POS
كنت بحبه	POS
محترم وجاد	POS
ملخبط	NEG
متربيه	POS
مز	POS
كسمك	NEG
ساداتي	NEG
خفيفه	POS
لزيزه	POS
حبيبتي متقوليش	Neutral
ملك ياسلام	POS
طيبان	POS
اتفشخ	NEG
وسخه بضان	NEG
فاهماها غلط	NEG
دكتور قلب	Neutral
جذمة	NEG
موهوب وصوته	POS
متدين	POS
شخصيه محترمه	POS
قميق	NEG
فنان	POS
مثقف ومحترم	POS
قطرائيلي	NEG
حنين	POS
اداؤه عجبني	POS
عبيط عبيط	Neutral
حبيبتي انجري	NEG
اغبيا	NEG
ايمانك	POS
حافي وجعان	NEG
لباس	NEG
اللبوه	NEG
متعفن	NEG
لواطي	NEG
حكيم	POS
شحات	NEG
قحبه	NEG
عاهه	NEG
صايعين	NEG
شبه	Neutral
اكيد	Neutral
مرح	POS
ديوس	NEG
ضب	NEG
جميله	POS
وسم	Neutral
حلو	POS
عدائي	NEG
مؤدب	POS
كانت سيس	NEG
اديته اعذار	NEG
حكومه	Neutral
ابيض	NEG
مخيف	NEG
مورد بلطجيه	NEG
فاسق	NEG
عاقل ومحترم	POS
فيه حالات	Neutral
بهيمة	NEG
احبه	POS
بجحه	NEG
فلقتين	NEG
هتموت	NEG
ابن	Neutral
مجيد	POS
عصبيه	NEG
وطنيه	POS
متخوبق	NEG
غلابة	NEG
وثوري بحترمك	POS
حلوه	POS
يشل جيش	NEG
اسمر انت حبيبي	POS
ارهابي	NEG
ارهابى	NEG
كيوت	POS
خيال	POS
منطقي	POS
صحرا	Neutral
رحمن	POS
متخلفين بيتفرجوا	NEG
بيبقي ارقي	POS
بتحبنا	POS
علق	NEG
شبه امي	Neutral
بارد	NEG
يفرقش عنهم	NEG
حاجات	Neutral
صعيديه الجدعه	POS
اولاد الوسخه	NEG
اخد افوره	Neutral
لقيط	NEG
بحبك	POS
شبه فلان	Neutral
حشري	NEG
ومزاج تاني	Neutral
نقي	POS
أسطورة	POS
طويطر مجنون	NEG
محروقه	NEG
ااخر تعيس	NEG
اغبيه	NEG
في الخيانه	NEG
بتاع سموحه	Neutral
ارهابيين	NEG
مبادئ غريبه	NEG
ابن الخروفه	NEG
خدمت البلد	POS
شخصي	Neutral
مهمه	POS
محنكه	POS
جسمها جامد	POS
عيلتة	Neutral
بجح	NEG
الكلب دي	NEG
لاسع	NEG
فرفوور	NEG
روقني	POS
نجم	POS
مفيد	POS
محترم بحترمك	POS
مفيش ابداع	NEG
رزل	NEG
شخصيه بضان	NEG
شرومطه	NEG
مريض	NEG
ابو وشين	NEG
كان بيهلفط	NEG
مؤذي	NEG
واولاد خشب	Neutral
منحرف	NEG
جااامد	POS
سرسجي	NEG
رجعي	NEG

