اباحه	negative
اباحي	negative
اباحيه	negative
اباد	negative
ابالسه	negative
ابتزاز	negative
ابتسام	positive
ابداع	positive
ابشع	negative
ابقى قابلنى	negative
ابله	negative
ابن المرة	negative
ابن المره	negative
ابن الهرمه	negative
ابن حلال	positive
ابوجهل	negative
ابو جهل	negative
ابيتم	positive
ابيح	negative
اتألش	negative
اتبسط	positive
اتبهدل	negative
اتبهدلت	negative
اتحاكم	negative
اتحبس	negative
اتحبست	negative
اتحكم	negative
اتحنطر	negative
اتخانق	negative
اتخدعت	negative
اتخمد	negative
اتخنقت	negative
اتدبحت	negative
اتذل	negative
اتربت	negative
اترحل	negative
اترمت	negative
اتسجنت	negative
اتسجنتم	negative
اتسحبت	negative
اتسحل	negative
اتسحلت	negative
اتسرق	negative
اتسرقت	negative
اتسول	negative
اتشتم	negative
اتشرفت	positive
اتشطف	negative
اتصدم	negative
اتضربوا	negative
اتطوع	positive
اتظلم	negative
اتعذبت	negative
اتعرت	negative
اتعروا	negative
اتعري	negative
اتعس	negative
اتغلب	negative
اتف	negative
اتفرتك	negative
اتفشخ	negative
اتفقست	negative
اتفو	negative
اتق الله	negative
اتقتل	negative
اتقتلوا	negative
اتقو الله	negative
اتقي	negative
اتقي الله	negative
اتقى الله	negative
اتكتم	negative
اتكسرت	negative
اتكسف	positive
اتلم	negative
اتلهي	negative
اتمسح بيه الارض	negative
اتمسح بيه البلاط	negative
اتمسح بيهم الارض	negative
اتنيل	negative
اتهانت	negative
اتهبلت	negative
اتهد	negative
اتهزم	negative
اتهمت	negative
اتهمته	negative
اتهمو	negative
اثق	positive
اجبار	negative
اجبن	negative
اجدع	positive
اجرام	negative
اجعلهم عبره	negative
اجلال	positive
اجلد	negative
اجمد	positive
اجمل	positive
إجهاض	negative
اجهاض	negative
اجهل	negative
احا	negative
احباب	positive
احباط	negative
احبب	positive
احبسو	negative
احبطو	negative
احتجاج	negative
احتجاجيه	negative
احتجاز	negative
احترام	positive
احترامك	positive
احترم	positive
احتشاد	positive
احتقر	negative
احتقرك	negative
احتكار	negative
احتل	negative
احتلال	negative
احتلت	negative
احذر	negative
احرار	positive
احراقها	negative
احرق	negative
احرمونا	negative
احسان	positive
احسن	positive
احسنت	positive
احسنلك	negative
احقر	negative
احلف	negative
احلي	positive
احمر	negative
احنا معاك	positive
احه	negative
احيك	positive
احيه	negative
احييك	positive
اختراع	positive
اختطاف	negative
اختفت	negative
اختلاف	negative
اخرس	negative
اخرسو	negative
اخرص	negative
اخس	negative
اخسر	negative
اخسئ	negative
اخشي	negative
اخص	negative
اخص علي	negative
اخطا	negative
اخطاء	negative
اخطاؤ	negative
اخطاؤه	negative
اخطائ	negative
اخطر	negative
اخلاص	positive
اخلاق	positive
اخن	negative
اخوه	positive
ادب	positive
ادعم	positive
ادغال	negative
ادمان	negative
اراجوز	negative
ارحل	negative
ارحم	negative
ارحمنا	positive
ارحمني	negative
ارحمونا	negative
اردح	negative
ارزل	negative
ارعن	negative
ارف	negative
ارفت	negative
ارفض	negative
ارهاب	negative
ارهابي	negative
اروع	positive
ازدراء	negative
ازعاج	negative
ازعر	negative
ازمات	negative
ازمه	negative
استاذ	positive
استبحس	negative
استبداد	negative
استبعاد	negative
استحل	negative
استحواذ	negative
استخفاف	negative
استرخصوك	negative
استشهد	negative
استظراف	negative
استعباد	negative
استعباط	negative
استعمار	negative
استغباء	negative
استغفلو	negative
استغل	negative
استغلال	negative
استغلالي	negative
استفاد	positive
استفزاز	negative
استقرار	positive
استكراد	negative
استنزاف	negative
استنطاع	negative
استنكر	negative
استهانه	negative
استهبال	negative
استهبل	negative
استهتار	negative
استهزاء	negative
استهزائك	negative
استيلاء	negative
اسف	negative
اسفاف	negative
اسفخص	negative
اسفي	negative
اسقاط	negative
اسقط	negative
اسكت	negative
اسمع كلامك اصدقك	negative
اسوا	negative
اسيادك	negative
اشاع	negative
اشتباك	negative
اشتعال	negative
اشتغال	negative
اشتم	negative
اشتمك	negative
اشتمو	negative
اشجع	positive
اشرف ناس	positive
اشرف واحد	positive
اشقاء	negative
اشكالكو	negative
اشمازاز	negative
اشمئزاز	negative
اصابه	negative
اصحاب المصالح	negative
اصطناع	negative
اصعب	negative
اصمت	negative
اصنام	negative
اصيب	negative
اصيل	positive
اضراب	negative
اضرب	negative
اضربو	negative
اضطراب	negative
اضطهاد	negative
اضمحلال	negative
اطاح	negative
اطرشيت	negative
اطماع	negative
اطيب 	positive
اظرف	positive
اعاصير	negative
اعتبار	negative
اعتباط	negative
اعتداء	negative
اعتراض	negative
اعترض	negative
اعتزاز	positive
اعتصام	negative
اعتصم	negative
اعتصمت	negative
اعتقال	negative
اعتلاك	negative
اعجاب	positive
اعجبتني	positive
اعدام	negative
اعدائك	negative
اعدمو	negative
اعذار	negative
اعريك	negative
اعزاز	negative
اعشق	positive
اعظم	positive
اعمل لكم ايه	negative
اعمي	negative
اعور	negative
اعيل	negative
اغباء	negative
اغبيا	negative
اغبياء	negative
أغبيه	negative
اغتال	negative
اغتصاب	negative
اغتصب	negative
اغتصبو	negative
اغتيال	negative
اغضب	negative
اغنام	negative
افاك	negative
افتر	negative
افتراء	negative
افتري	negative
افتعال	negative
افراج	positive
افرح	positive
افرم	negative
افساد	negative
افسد	negative
افسدت	negative
افشل	negative
افضحو	negative
افضل	positive
افلاس	negative
افلس	negative
اقبح	negative
اقتحام	negative
اقتحم	negative
اقدر	positive
اقذر	negative
أقرع ونزهى	negative
اقصاء	negative
اقهرك	negative
اقوي	positive
اكاذيب	negative
اكتساح	positive
اكتئاب	negative
اكدب	negative
اكذب	negative
اكذوبه	negative
اكرم	positive
اكره	negative
اكفر	negative
الابداع	positive
الاحرار	positive
الاستقرار	positive
الاشراف	positive
الاعتراف	positive
الافتراء	negative
الافراج	positive
الاقنعه	negative
الالتزام	negative
الام	negative
الامل	positive
الانفلات	negative
الانقاض	negative
الانقسام	negative
الاهتمام	positive
البجاحه	negative
البلاغ	negative
البلطجي	negative
البلطجيه	negative
التحريض	negative
التحيه	positive
التزم	positive
التسامح	positive
التطهير	positive
التعذيب	negative
التناقض	negative
الجدعان	positive
الجفاف	positive
الحاد	negative
الحافي	negative
الحائر	negative
الحريه	positive
الحشاش	negative
الحمد	positive
الحمدالله	positive
الحمد الله	positive
الحمد لله	positive
الحياد	positive
الخير	positive
الدبابات	negative
الذ	positive
الذوق الرفيع	positive
الرياء	negative
الزباله	negative
السجن	negative
السرقه	negative
السعيد	positive
الشجاعه	positive
الشجب	negative
الشفا	negative
الشهداء	negative
الصراع	negative
الضحك	positive
الطاغيه	negative
الطين بله	negative
العاهرات	negative
العداله	positive
العفو	positive
العك	negative
العنف	negative
العيب	negative
الغباء	negative
الغبي	negative
الغريبه	negative
الغلط	negative
الغلطان	negative
الفاحش	negative
الفاسد	negative
الفاسدين	negative
الفران	negative
الف شكر	positive
الفل	positive
الفوضي	negative
القضاء علي	negative
القمر	positive
الله اكبر	positive
الله غالب	positive
اللهم اخزه	negative
الله يحرقك	negative
الله يحرقكو	negative
الله يحميك	positive
الله يحميكم	positive
الله يكون فى عون	positive
الله يلعن	negative
الله يمسيك بالخير	positive
الله يمسيه بالخير	positive
الله ينور	positive
اللي اختاشو ماتو	negative
الم	negative
المتاجره بالدين	negative
المتظاهرون	negative
المجد	positive
المحبوس	negative
المحترفين	positive
المخلوع	negative
المسانده	positive
المشكله	negative
المظاهرات	negative
المعارضين	negative
المعتقلين	negative
المعتقليين	negative
المعقم	negative
المهربه	negative
المؤامرات	negative
النصيبه	negative
النقض	negative
الوحش	negative
الى الامام	positive
الي الجحيم	negative
الي زوال	negative
ام العجايب	negative
امان	positive
امانته	positive
امانه	positive
امثل	negative
امكو	negative
امل	positive
امن	positive
اموت	negative
امين	positive
انا معاك	positive
انانيتك	negative
انبسط	positive
انبسطت	positive
انبسطوا	positive
انبش	negative
انتحار	negative
انتحر	negative
انتحرت	negative
انتش	negative
انتصار	positive
انتصر	positive
انتقاد	negative
انتقاض	negative
انتقام	negative
انتقد	negative
انتقم	negative
انتن	negative
انتهار	negative
انتهاز	negative
انتهازي	negative
انتهاك	negative
انتهكت	negative
انجاس	negative
انجرحت	negative
انجس	negative
انحدار	negative
انحدرت	negative
انحطاط	negative
اندال	negative
اندل	negative
انساني	positive
انسب	positive
انسحب	negative
انسرق	negative
انشغال	negative
انصار	positive
انصر	positive
انضرب	negative
انظف	positive
انظلم	negative
انفصال	negative
انفصام	negative
انفعل	negative
انقطاع	negative
انقلاب	negative
انقلاب 	negative
انكشفت	negative
انيق	positive
انيل	negative
اهاجم	negative
اهانه	negative
اهانو	negative
اهبل	negative
اهبل بريالة	negative
اهدار	negative
اهدار كرامه	negative
اهطل	negative
اهم	positive
اهمال	negative
اهمد	negative
اهنيك	positive
أهو كدة	positive
اوباش	negative
اوبئه	negative
اوساخ	negative
اوسخ	negative
اوع	negative
اوعا	negative
اوعوا	negative
اومك	negative
اونطجي	negative
اونطه	negative
اؤيد	positive
اؤيدك	positive
اياكم	negative
ايام سوده	negative
ايجاب	positive
ايجابي	positive
ايدز	negative
ايذائه	negative
اي كلام	negative
ايمان	positive
ايمانك	positive
اين انتم من	negative
ايهانه	negative
ايوه كده	positive
باتحادنا	negative
باحبك	positive
باحترمك	positive
باحتقرك	negative
باخطاء	negative
بارع	positive
بارك الله فيك	positive
باطل	negative
باظت	negative
باع	negative
باعو	negative
بالتظاهر	negative
بالتوفيق	positive
بالسلامه	positive
بالعافيه 	negative
بالعند فيك	negative
بالعند فيكم	negative
بالعند فيكي	negative
بالعند فيكى	negative
بالهروب	negative
بالهنا	positive
بانبسط	positive
بانجو	negative
بانكار	negative
باهزر	negative
باهظ	negative
بائد	negative
بايخ	negative
بايظ	negative
بتاخد فيها	negative
بتاع مصلحته	negative
بتاع مصلحه	negative
بتاكلك	negative
بتبجح	negative
بتبلطج	negative
بتبهدل	negative
بتبوظ	negative
بتتبل	negative
بتتحرق	negative
بتتسحل	negative
بتتسرق	negative
بتتشتم	negative
بتتشطر	negative
بتتضرب	negative
بتتظاهر	negative
بتتفقع	negative
بتتكسر	negative
بتتناك	negative
بتجوع	negative
بتحبك	positive
بتحترم	positive
بتحترمك	positive
بتحرض	negative
بتحشش	negative
بتخاف	negative
بتخر	negative
بتخرب	negative
بتخون	negative
بتذل	negative
بتراجع	negative
بتريل	negative
بتزعق	negative
بتزغرط	positive
بتستظرف	negative
بتشتم	negative
بتشتمو	negative
بتصرخ	negative
بتضايقك	negative
بتضيع	negative
بتفهم	positive
بتقل	negative
بتكدب	negative
بتلحس جزم	negative
بتموت	negative
بتناضل	negative
بتنجح	positive
بتنجس	negative
بتهاجم	negative
بتهاجمك	negative
بتهتف	negative
بتهرتل	negative
بتهزر	negative
بتهيج	negative
بتوجع	negative
بتوع مصالح	negative
بتوع مصلحتكم	negative
بتوع مصلحتهم	negative
بتوع مصلحه	negative
بتولع	negative
بجاحتك	negative
بجاحه	negative
بجح	negative
بجم	negative
بجهل	negative
بحبك	positive
بحبك موت	positive
بحبكو	positive
بحبه	positive
بحبها	positive
بحبوا	positive
بحترمك	positive
بحترمو	positive
بحزرك	negative
بخبث	negative
بدمار	negative
بديع	positive
بذاء	negative
بذائه	negative
بذيء	negative
بذيئ	negative
بر	positive
برافو	positive
بردع	negative
بردعه	negative
برسيم	negative
برشم	negative
برطوش	negative
برع	positive
بركاتك	positive
برنس	positive
برئ	positive
برياله	negative
بريئه	positive
بزمتك	negative
بسب	negative
بسباب	negative
بسببك	negative
بسكاتك	negative
بسيط	negative
بشتم	negative
بشع	negative
بضن	negative
بضيع	negative
بطاله	negative
بطش	negative
بطل	positive
بطئ	negative
بظرميط	negative
بظلمك	negative
بعبع	negative
بعتذر	positive
بعيب	negative
بعيط	negative
بغال	negative
بغباؤه	negative
بغدر	negative
بغض	negative
بغضا	negative
بغل	negative
بغيظ	negative
بغيظكم	negative
بفتات	negative
بقتلو	negative
بقر	negative
بكره احلى	positive
بكرهك	negative
بكي	negative
بلاهه	negative
بلا وكسه	negative
بلاوي	negative
بلط	negative
بلطج	negative
بلطجه	negative
بلطجي	negative
بلطجيه	negative
بلع	negative
بلهاء	negative
بن المره	negative
بنتسحل	negative
بنتعر	negative
بنتكلم	negative
بنحبك	positive
بنحرق	negative
بنخاف	negative
بندمر	negative
بنركبك	negative
بنزيف	negative
بنشتم	negative
بنضرب	negative
بنعقد	negative
بنعيد	negative
بنفضح	negative
بنكذب	negative
بنكرهك	negative
بهاايم	negative
بهائم	negative
بهايم	negative
بهتان	negative
بهج	positive
بهجه	positive
بهدل	negative
بهدلتو	negative
بهدله	negative
بهوس	negative
بهيم	negative
بهيمه	negative
بوذ	negative
بوس	positive
بوسه	positive
بوظ	negative
بيتجنن	negative
بيتريق	negative
بيتشتم	negative
بيتشطف	negative
بيتظاهروا	negative
بيتعصب	negative
بيتعل	negative
بيتفرج	negative
بيتفرجوا	negative
بيتقتل	negative
بيتنطط	negative
بيتنك	negative
بيتهبل	negative
بيحب	positive
بيحبط	negative
بيحترمها	positive
بيحتل	negative
بيحرض	negative
بيحشش	negative
بيخطفو	negative
بيخطئ	negative
بيره	negative
بيزعق	negative
بيستغل	negative
بيستهبل	negative
بيشتم	negative
بيشتمك	negative
بيشتموك	negative
بيشتم 	negative
بيشمت	negative
بيض	negative
بيضحك	positive
بيضحك علي	negative
بيضربو	negative
بيطرش	negative
بيظبط	negative
بيعيط	negative
بيغلط	negative
بيفرق	negative
بيقبض	negative
بيقبضو	negative
بيقبضوك	negative
بيكابر	negative
بيكدب	negative
بيكذب	negative
بيلحس جزم	negative
بيلطش	negative
بيموتو	negative
بيموتوا	negative
بيناضل	negative
بينام	negative
بينتحل	negative
بينداس	negative
بيهجص	negative
بيهدد	negative
بيهرب	negative
بيهرتل	negative
بيهزر	negative
بيهش	negative
بيهفلت	negative
بيهلفط	negative
بيهيج	negative
تاخدك	negative
تافهه	negative
تاكلك	negative
تائب	positive
تايه	negative
تايهه	negative
تبذ	negative
تبرع	positive
تبضن	negative
تبطل	negative
تبك	negative
تبكي	negative
تبيح	negative
تتجاهل	negative
تتحبس	negative
تتحبسوا	negative
تتحرق	negative
تتخاذل	negative
تتخاصم	negative
تتخزوق	negative
تتخض	negative
تتخطف	negative
تتخلي	negative
تتدخل	negative
تتراجع	negative
تتربي	negative
تترحم	negative
تتردد	negative
تتركوا	negative
تتريق	negative
تتسجن	negative
تتسحل	negative
تتسلح	negative
تتسول	negative
تتشرد	negative
تتشل	negative
تتشلح	negative
تتصاب	negative
تتطاول	negative
تتظاهر	negative
تتظاهرون	negative
تتظلم	negative
تتعارض	negative
تتعدم	negative
تتعذب	negative
تتعر	negative
تتعرض	negative
تتعقب	negative
تتفق	positive
تتقبض	negative
تتقتلو	negative
تتقمص	negative
تتكتم	negative
تتكسف	negative
تتلسع	negative
تتلم	negative
تتمسح	negative
تتناك	negative
تتنح	negative
تتنفخ	negative
تتنكر	negative
تتنيل	negative
تتهد	negative
تتهدد	negative
تتهم	negative
تتواطا	negative
تتوب	negative
تتوكس	negative
تثق	positive
تجادل	negative
تجار دين	negative
تجاملك	positive
تجاهل	negative
تجبر	negative
تجتهد	positive
تجرح	negative
تجرعت	negative
تجرو	negative
تجريح	negative
تجريم	negative
تجنن	negative
تجوع	negative
تجويع	negative
تحارب	negative
تحاسب	negative
تحاصر	negative
تحاكمك	negative
تحالف	positive
تحايل	negative
تحبط	negative
تحبك	positive
تحتج	negative
تحترق	negative
تحترم	positive
تحتفل	positive
تحتقر	negative
تحدي	positive
تحذر	negative
تحذير	negative
تحرسك	positive
تحرش	negative
تحرصك	positive
تحرق	negative
تحرم	negative
تحرمنا	negative
تحرمو	negative
تحريض	negative
تحزن	negative
تحسد	negative
تحسس	negative
تحسسو	negative
تحشر	negative
تحشيش	negative
تحطم	negative
تحفز	positive
تحفظ	positive
تحفظك	positive
تحفه	positive
تحقير	negative
تحك	negative
تحمي	positive
تحميك	positive
تحن	positive
تحي	positive
تحيا	positive
تحيك	positive
تحيه	positive
تخاذل	negative
تخب	negative
تخترق	negative
تخجل	negative
تخدر	negative
تخدع	negative
تخدك	negative
تخذلكم	negative
تخرب	negative
تخرس	negative
تخرص	negative
تخز	negative
تخسر	negative
تخش	negative
تخشي	negative
تخض	negative
تخطء	negative
تخطيء	negative
تخطئ	negative
تخوف	negative
تخون	negative
تخونو	negative
تخويف	negative
تخوين	negative
تخيف	negative
تخين	negative
تدافع	negative
تدعم	positive
تدعمك	positive
تدعمه	negative
تدعي	negative
تدلس	negative
تدليس	negative
تدمر	negative
تدمير	negative
تدني	negative
تدهور	negative
تذبح	negative
تراجع	negative
تراشق	negative
تراق	negative
تربح	positive
تربيك	negative
تربيه	negative
ترتاح	positive
ترتجف	negative
ترحب	positive
ترحل	negative
ترحم	positive
ترحمك	positive
ترحمه	positive
ترشد	positive
ترعب	negative
ترفض	negative
ترك	negative
تركب	negative
تركبك	negative
تركيع	negative
ترمادول	negative
ترن	negative
ترهيب	negative
تريحك	positive
تزرط	negative
تزعلك	negative
تزعلو	negative
تزلزل	negative
تزهق	negative
تزوغ	negative
تزيح	positive
تزيط	negative
تزييف	negative
تسامح	positive
تستاهلوا	negative
تستبعد	negative
تستبيحو	negative
تستجعل	negative
تستحي	positive
تستخف	negative
تستدرج	negative
تستسلم	negative
تستغفر	positive
تستغل	negative
تستغيث	negative
تستفيد	positive
تستقر	positive
تستلم	negative
تستنجد	negative
تستنزف	negative
تستنكرون	negative
تستهبلوش	negative
تستهزء	negative
تسجن	negative
تسخن	negative
تسرق	negative
تسرقو	negative
تسريب	negative
تسعد	positive
تسعدك	positive
تسعدنا	positive
تسفل	negative
تسقط	negative
تسقطو	negative
تسكت	negative
تسلط	negative
تسلم اديك	positive
تسلم ايدك	positive
تسلمي	positive
تسليح	negative
تسليط	negative
تسهم	positive
تسهيل	positive
تسول	negative
تسيئ	negative
تشاور	positive
تشتيت	negative
تشجب	negative
تشد	negative
تشدد	negative
تشرذم	negative
تشرف	positive
تشعل	negative
تشفيك	positive
تشكر	positive
تشكرك	positive
تشل	negative
تشوه	negative
تشوهو	negative
تشويهه	negative
تشيع	negative
تشيل	negative
تصاب	negative
تصبر	positive
تصبرك	negative
تصتدم	negative
تصح	positive
تصد	positive
تصدق	positive
تصرخ	negative
تصفيه	negative
تصلح	positive
تصمت	negative
تصيح	negative
تضامن	positive
تضحك	positive
تضحك علينا	negative
تضر	negative
تضرب	negative
تضربك	negative
تضطر	negative
تضعف	negative
تضللو	negative
تضليل	negative
تضيع	negative
تضييع	negative
تطاول	negative
تطبيل	negative
تطرف	negative
تطع	negative
تطعن	negative
تطغ	negative
تطغي	negative
تطلع عين	negative
تطمئن	positive
تطهر	negative
تطهير	positive
تطوير	positive
تظاهر	negative
تظلم	negative
تعارض	negative
تعاطف	positive
تعاقب	negative
تعاقبه	negative
تعاون	positive
تعب	negative
تعبت	negative
تعتدوا	negative
تعتذر	positive
تعترض	negative
تعترف	negative
تعتفر	negative
تعتقل	negative
تعجبن	positive
تعجبني	positive
تعجيز	negative
تعدم	negative
تعدي	negative
تعدياً	negative
تعذب	negative
تعذبو	negative
تعذيب	negative
تعر	negative
تعرص	negative
تعري	negative
تعريس	negative
تعريص	negative
تعريك	negative
تعريه	negative
تعزك	positive
تعزل	negative
تعزلوا	negative
تعسر	negative
تعسف	negative
تعشق	positive
تعصي	negative
تعفف	positive
تعفو	positive
تعقل	positive
تعل	negative
تعمير	positive
تعور	negative
تعورو	negative
تعورين	negative
تعويض	negative
تعيط	negative
تغتصب	negative
تغرق	negative
تغش	negative
تغضب	negative
تغلط	negative
تغور	negative
تغيب	negative
تغيير	positive
تف	negative
تفاءل	positive
تفاهه	negative
تفاؤل	positive
تفتت	negative
تفتر	negative
تفتقد	positive
تفتن	negative
تفتي	negative
تفتيت	negative
تفتيش	negative
تفجير	negative
تفديك	positive
تفر	negative
تفرح	positive
تفرس	negative
تفرفر	negative
تفرقه	negative
تفريق	negative
تفسد	negative
تفشخ	negative
تفشخك	negative
تفشل	negative
تفضح	negative
تفضحك	negative
تفلح	positive
تفلس	negative
تفهمك	positive
تفو	negative
تفوقوا	negative
تقاضي	negative
تقاعس	negative
تقاعص	negative
تقاوم	negative
تقبض	negative
تقبل	positive
تقتحم	negative
تقتص	negative
تقتل	negative
تقتلك	negative
تقتلو	negative
تقدرك	positive
تقدم	positive
تقدير	positive
تقريص	negative
تقصر	negative
تقضي	negative
تقع	negative
تقل	negative
تقل دم	negative
تقليل	negative
تقويكي	positive
تقي	positive
تقيل	negative
تكاتف	positive
تكتم	negative
تكحمك	negative
تكذبوا	negative
تكذيب	negative
تكر	negative
تكرم	positive
تكرمك	positive
تكرمه	positive
تكره	negative
تكرهك	negative
تكسب	positive
تكسر	negative
تكسرو	negative
تكسير	negative
تكشف	negative
تكفل	positive
تكلك	negative
تلاعب	negative
تلتزم	positive
تلجا	negative
تلطش	negative
تلعنك	negative
تلغي	negative
تلقن	negative
تلم	negative
تلميح	negative
تلوث	negative
تليف	negative
تماطل	negative
تمثيل	negative
تمرد	negative
تمسخرك	negative
تمكر	negative
تمنع	negative
تمويه	negative
تميز	positive
تناغم	positive
تنافق	negative
تناقض	negative
تنتحل	negative
تنتصر	positive
تنتقد	negative
تنتقم	negative
تنتن	negative
تنتهي	negative
تنجح	positive
تنح	negative
تنحني	negative
تنخرس	negative
تندد	negative
تنديد	negative
تنرفز	negative
تنرفزن	negative
تنزع	negative
تنزف	negative
تنس	negative
تنسو	negative
تنصر	positive
تنصرك	positive
تنصره	positive
تنصرهم	positive
تنصف	positive
تنضرب	negative
تنظيم	positive
تنعم	positive
تنفخ	negative
تنفضح	negative
تنقط	negative
تنكر	negative
تنكرها	negative
تنهبو	negative
تنهزم	negative
تنهض	positive
تنور	positive
تنيكك	negative
تنين	negative
تهاجم	negative
تهان	negative
تهاني	positive
تهب	negative
تهتك	negative
تهد	negative
تهدد	negative
تهدر	negative
تهدم	negative
تهدي	positive
تهديد	negative
تهديك	positive
تهرتل	negative
تهزء	negative
تهزئ	negative
تهزيق	negative
تهش	negative
تهكم	negative
تهمل	negative
تهمه	negative
تهنئ	positive
تهور	negative
تهيج	negative
تهين	negative
تهييس	negative
تهييص	negative
تواضع	positive
تواضعا	positive
تواطؤ	negative
توافق	positive
توتر	negative
تؤتمن	positive
توجع	negative
تؤجل	negative
تورط	negative
توري	negative
توريط	negative
توضيح	positive
توفقك	positive
تولعو	negative
تولول	negative
توليع	negative
تؤيد	positive
ثعلب	negative
جازم	negative
جاسوس	negative
جامد اوي	positive
جامدة اوي	positive
جامل	positive
جاموس	negative
جاهل	negative
جائر	negative
جايف	negative
جبار	negative
جبان	negative
جبر	negative
جبروت	negative
جبن	negative
جبنك	negative
جثث	negative
جثمان	negative
جثه	negative
جحش	negative
جحود	negative
جحيم	negative
جدع	positive
جدعان	positive
جدعنه	positive
جدل	negative
جدير	positive
جذم	negative
جراح	negative
جربوع	negative
جرح	negative
جرف	negative
جريء	positive
جريمه	negative
جريئه	positive
جزاك الله خيرا	positive
جزم	negative
جزمه	negative
جشع	negative
جعان	negative
جفاء	negative
جلاد	negative
جلد	negative
جلط	negative
جلطه	negative
جليل	positive
جمال	positive
جمالك	positive
جمود	negative
جموس	negative
جميل	positive
جنات	positive
جنائي	negative
جنايه	negative
جن جنونه	negative
جن جنونها	negative
جنحه	negative
جنس	negative
جنن	negative
جننتو	negative
جننو	negative
جهال	negative
جهل	negative
جهنم	negative
جهيل	negative
جواسيس	negative
جيد	positive
جيص	negative
جيوش	negative
حابس	negative
حاجة تكسف	negative
حارب	negative
حازق	negative
حاسب	negative
حاسم	positive
حاصر	negative
حافظ مش فاهم	negative
حاقد	negative
حاكم	negative
حامي	positive
حانتحر	negative
حب	positive
حبايب	positive
حبس	negative
حبسجي	negative
حبط	negative
حبك	positive
حبه	positive
حبيب	positive
حبيبت	positive
حبيبتي	positive
حبيب قلبي	positive
حبيبك	positive
حبيبه قلبي	positive
حبيبي	positive
حبيس	negative
حتتفشخ	negative
حتضييع	negative
حثال	negative
حجه	negative
حدق	negative
حذاء	negative
حذاري	negative
حذر	negative
حر	positive
حرا	positive
حراسه	negative
حرام	negative
حرامي	negative
حرب	negative
حرباً	negative
حرج	negative
حرر	positive
حرس	positive
حرض	negative
حر طليق	positive
حرف	negative
حرق	negative
حرم	negative
حريق	negative
حريه	positive
حزر	negative
حزمه	negative
حزن	negative
حزومبل	negative
حزين	negative
حسبنا الله ونعم الوكيل	negative
حسبي الله ونعم الوكيل	negative
حسبى الله ونعم الوكيل	negative
حسد	negative
حسره	negative
حسس	negative
حش	negative
حشاش	negative
حشر	negative
حشره	negative
حشش	negative
حشمتها	positive
حشيش	negative
حشيشه	negative
حصار	negative
حضن	positive
حطم	negative
حظر	negative
حفز	positive
حفظ	positive
حق	positive
حقاره	negative
حقبه	negative
حقد	negative
حقدك	negative
حقر	negative
حق غير شرعي	negative
حقود	negative
حقوقيه	positive
حقير	negative
حل	positive
حلاوتك	positive
حلاوه	positive
حلف	negative
حلو	positive
حلوتك	positive
حلوه	positive
حلوين	positive
حمار	negative
حماقتك	negative
حماقه	negative
حمايه	positive
حمدالله	positive
حمد الله	positive
حمرا	negative
حمش	positive
حنان	positive
حنخلص	negative
حنضيع	negative
حنموت	negative
حوادث	negative
حوست	negative
حياد	positive
حيادي	positive
حياديه	positive
حيتخلع	negative
حيضيع	negative
حيل	negative
حيموت	negative
حيوان	negative
خابور	negative
خادع	negative
خارب	negative
خارق	positive
خازوق	negative
خاسر	negative
خاصم	negative
خاطف	negative
خاطئ	negative
خاف	negative
خالف	negative
خان	negative
خانو	negative
خائب	negative
خائف	negative
خائن	negative
خائنو	negative
خايب	negative
خايف	negative
خاين	negative
خبتكو	negative
خبث	negative
خبط	negative
خبطت	negative
خبيت	negative
خبيث	negative
خجل	positive
خداع	negative
خدر	negative
خدع	negative
خذل	negative
خرا	negative
خراب	negative
خراشي	negative
خراف	negative
خرافه	negative
خرب	negative
خربان	negative
خربت	negative
خربتو	negative
خربو	negative
خربوا	negative
خرس	negative
خرسان	negative
خرست	negative
خرص	negative
خرطوش	negative
خرنق	negative
خره	negative
خريس	negative
خزعبل	negative
خزعبلي	negative
خزوق	negative
خزي	negative
خسارتك	negative
خساره	negative
خساسه	negative
خسر	negative
خسرت	negative
خسرتك	negative
خسرناك	negative
خسه	negative
خسئتم	negative
خسيس	negative
خش	negative
خصومهم	negative
خطء	negative
خطا	negative
خطر	negative
خطف	negative
خطوره	negative
خطئ	negative
خطير	negative
خطيرا	negative
خف	negative
خفه	negative
خلص	negative
خلصو	negative
خلع	negative
خلق	positive
خلل	negative
خمر	negative
خنازير	negative
خنق	negative
خنوع	negative
خوازيق	negative
خوف	negative
خوفك	negative
خول	negative
خولات	negative
خون	negative
خونتو	negative
خيانه	negative
خيبتك	negative
خيبه	negative
خيخا	negative
خير	positive
خيسه	negative
خيل	negative
دابه	negative
داس	negative
داعر	negative
دافئ	positive
داهيه تاخدك	negative
في داهيه negative
دبح	negative
دبحتن	negative
دجال	negative
دجل	negative
دزم	negative
دعابه	positive
دعاره	negative
دعاوي	negative
دعس	negative
دعم	positive
دكتاتور	negative
دكر	positive
دلدول	negative
دم	negative
دماء	negative
دمار	negative
دمائه	negative
دم تقيل	negative
دمر	negative
دمع	negative
دمعا	negative
دمكم	negative
دمها تقيل	negative
دمه تقيل	negative
دمه خفيف	positive
دمهم تقيل	negative
دموع	negative
دموي	negative
دني	negative
دنيء	negative
دهاء	negative
ده آخره	negative
دهاك	negative
دهس	negative
دهيه	negative
دياث	negative
ديوس	negative
ذباب	negative
ذبال	negative
ذبح	negative
ذبحو	negative
ذعر	negative
ذكي	positive
ذل	negative
ذليل	negative
ذنوبي	negative
ذهل	positive
ذوق	positive
ذئب	negative
راجل ناقص	negative
راسخ	positive
رافص	negative
راق	negative
راقص	negative
راكبك	negative
رائد	positive
رائع	positive
ربايه	negative
ربح	positive
ربنا معاك	negative
ربنا معاكم	negative
ربنا ياخدك	negative
ربنا يبارك	positive
ربنا يحمي	positive
ربنا يحميك	positive
ربنا يخد	negative
ربنا يخدك	negative
ربنا يخدكم	negative
ربنا يخده	negative
ربنا يزيد	positive
ربنا يزيد ويبارك	positive
ربنا يسعدك	positive
ربنا يكتر من	positive
ربنا يكثر من	positive
ربنا يكثر من امثالك	positive
ربنا يكرمك	positive
ربنا يهده	negative
ربنا يهدي	negative
ربنا يهديك	negative
ربنا يوفقك	positive
رجع	negative
رجم	negative
رجوله	positive
رحب	positive
رحل	negative
رحم	positive
رحمه	positive
رحيم	positive
رخاوه	negative
رخيص	negative
ردح	negative
ردع	negative
رذيله	negative
رزع	negative
رزل	negative
رشاش	negative
رشد	positive
رشوه	negative
رصاص	negative
رصاصه	negative
رعاع	negative
رعب	negative
رعبا	negative
رغاي	negative
رفسه	negative
رفض	negative
رفيق	positive
رقاص	negative
رقص	negative
رقصن	positive
رقيق	positive
ركب	negative
ركع	negative
ركيك	negative
رما	negative
رمم	negative
رنوه علقه	negative
رهيب	negative
رهينه	negative
روث	negative
روحك	negative
روحمك	negative
روعه	positive
رويبض	negative
رياله	negative
ريح	positive
زال	negative
زاني	negative
زائف	negative
زائل	negative
زباله	negative
زبانيه	negative
زبر	negative
زج	negative
زجت	negative
زحم	positive
زحمه	negative
زراط	negative
زرط	negative
زعابيب	negative
زعج	negative
زعر	negative
زعق	negative
زعل	negative
زعلان	negative
زعلت	negative
زعيق	negative
زغط	negative
زفاره	negative
زفت	negative
زفتت	negative
زفه	positive
زقطط	positive
زكي	positive
زلازل	negative
زله	negative
زنا	negative
زنب	negative
زنبورها	negative
زندق	negative
زنديق	negative
زنزان	negative
زني	negative
زهايمر	negative
زهق	negative
زهقت	negative
زهقو	negative
زوال	negative
زور	negative
زي العسل	positive
زيط	negative
زيف	negative
ساخر	negative
ساذج	negative
سارق	negative
سارقو	negative
سازج	negative
سافضح	negative
سافك	negative
سافل	negative
ساقط	negative
ساكت	negative
سالم	positive
ساند	positive
سايس	negative
سب	negative
سباب	negative
سبكو	negative
سبه	negative
سبها	negative
سبهلل	negative
سبهم	negative
سبو	negative
سبي	negative
ستحتل	negative
ستفتضح	negative
ستنتصر	positive
ستهم	positive
سجن	negative
سحاق	negative
سحب	negative
سحبها	negative
سحل	negative
سحلت	negative
سحلو	negative
سخافتك	negative
سخافه	negative
سخر	negative
سخريتك	negative
سخريه	negative
سخف	negative
سخن	negative
سخيف	negative
سذاجه	negative
سذج	negative
سرعة بديهه	positive
سرق	negative
سرقت	negative
سرقه	negative
سرقو	negative
سرور	positive
سزاجه	negative
سطحي	negative
سعاد	positive
سعاده	positive
سعدت	positive
سعران	negative
سعيد	positive
سفاح	negative
سفاحا	negative
سفاف	negative
سفاقه	negative
سفاله	negative
سفاهه	negative
سفك	negative
سفل	negative
سفله	negative
سفه	negative
سفهاء	negative
سفيه	negative
سقط	negative
سقطت	negative
سقوطك	negative
سكت	negative
سكر	negative
سكير	negative
سكين	negative
سلام	positive
سلامات	positive
سلامتك	positive
سلب	negative
سلبي	negative
سلبيات	negative
سلبيتهم	negative
سلط	negative
سلطانيه	negative
سلطوه	negative
سلم	positive
سليط	negative
سليط اللسان	negative
سليم	positive
سم	negative
سماح	positive
سماحه	positive
سمسم	positive
سمعه	positive
سمم	negative
سمومك	negative
سنج	negative
سنحاسب	positive
سند	positive
سننتصر	positive
سهتان	negative
سهم	positive
سوء	negative
سوء الاداره	negative
سوء الحظ	negative
سواد	negative
سوسه	negative
سوط	negative
سيس	negative
سيقمع	negative
سيلعن	negative
سينس	negative
سيئ	negative
شابوا	positive
شاخخ	negative
شاد	negative
شاذ	negative
شافط	negative
شامخ	positive
شائع	negative
شباشب	negative
شبشب	negative
شبه	negative
شتايم	negative
شتت	negative
شتم	negative
شتمت	negative
شتمو	negative
شتيمه	negative
شجاع	positive
شجاعه	positive
شجب	negative
شجع	positive
شجعان	positive
شخ	negative
شخر	negative
شدد	negative
شذوذ	negative
شر	negative
شر البليه ما يضحك	negative
شراميط	negative
شرد	negative
شرس	negative
شرشح	negative
شرشر	negative
شرعي	positive
شرف	positive
شرفت	positive
شرمط	negative
شرموط	negative
شرموطه	negative
شرير	negative
شريف	positive
شطه	negative
شعبيه	positive
شفاء	positive
شفط	negative
شق	negative
شك	negative
شكر	positive
شكرا	positive
شكك	negative
شكم	positive
شكوي	negative
شكي	negative
شل	negative
شلل	negative
شلوط	negative
شماريخ	negative
شمام	negative
شمتان	negative
شمخ	positive
شهامه	positive
شهم	positive
شهوات	negative
شهواتك	negative
شهوه	negative
شوخير	negative
شوشر	negative
شوم	negative
شوه	negative
شوهت	negative
شياكه	positive
شيطان	negative
شيطن	negative
شيع	negative
صابتن	negative
صاحب	positive
صاحي	positive
صادق	positive
صاف	positive
صافي	positive
صالح	positive
صالحه	positive
صامت	negative
صامتون	negative
صائب	positive
صايع	negative
صباح الورد	positive
صبر	positive
صبور	positive
صح	positive
صحبه	positive
صحيح	positive
صحيحه	positive
صحيه	positive
صدفه	negative
صدق	positive
صدقه	positive
صدم	negative
صديق	positive
صراحه	positive
صراخ	negative
صراع	negative
صراعات	negative
صرخ	negative
صرصار	negative
صرع	negative
صريح	positive
صعب	negative
صعبه	negative
صغننه	positive
صفاقه	negative
صفحة جديدة	positive
صفع	negative
صفيق	negative
صلبو	negative
صلح	positive
صليبي	negative
صمت	negative
صمود	negative
صهاينه	negative
صهيون	negative
صهيوني	negative
صيع	negative
ضاع	negative
ضاعت	negative
ضال	negative
ضائع	negative
ضايع	negative
ضجيج	negative
ضحاله	negative
ضحاله الفكر	negative
ضحك	positive
ضحك عليا	negative
ضحك عليك	negative
ضحك علينا	negative
ضحكه	positive
ضحل	negative
ضد	negative
ضده	negative
ضدي	negative
ضرب	negative
ضرب الجزم	negative
ضربت	negative
ضرب تحت الحزام	negative
ضربو	negative
ضرر	negative
ضعاف	negative
ضعف	negative
ضعفك	negative
ضعيف	negative
ضلال	negative
ضلل	negative
ضلمه	negative
ضمير	positive
ضياع	negative
ضيع	negative
ضيق	negative
طاح	negative
طاعن	negative
طاغي	negative
طاغيه	negative
طامعين	negative
طاهر	positive
طاوعن	negative
طائش	negative
طايقاك	positive
طبال	negative
طبطب	negative
طبل	negative
طحن	negative
طخين	negative
طراطير	negative
طرد	negative
طرطور	negative
طرقع	negative
طرمخ	negative
طرمخ 	negative
طز	negative
طظ	negative
طعان	negative
طعن	negative
طعنًا	negative
طغي	negative
طغيان	negative
طفح	negative
طفش	negative
طلع عين	negative
طلق	negative
طماع	negative
طمس	negative
طمع	negative
طهاره	positive
طهر	positive
طوبه	negative
طور	positive
طويل اللسان	negative
طيب	positive
طيز	negative
طيزك	negative
طيزه	negative
طيش	negative
طيظك	negative
ظالم	negative
ظريف	positive
ظلام	negative
ظلم	negative
ظلما	negative
ظلمه	negative
عابوك	negative
عاجب	positive
عاجبني	positive
عاجبهم	positive
عادل	positive
عار	negative
عارك	negative
عاركه	negative
عاشت	positive
عاصف	negative
عاطل	negative
عاق	negative
عاقب	negative
عاقل	positive
عالخيبه	negative
عامر	positive
عاهر	negative
عبث	negative
عبره	negative
عبره لغيرك	negative
عبره لغيره	negative
عبره لغيرهم	negative
عبره لكل	negative
عبط	negative
عبقري	positive
عبوا	negative
عبيد	negative
عبيط	negative
عتم	negative
عتوا	negative
عثل	positive
عجب	negative
عجرف	negative
عجرفة	negative
عجز	negative
عجزهم	negative
عجل	negative
عجيبني	positive
عداك العيب	positive
عداله	positive
عدائي	negative
عدل	positive
عدلا	positive
عدو	negative
عدوي	negative
عذاب	negative
عذب	positive
عذبت	negative
عذر	negative
عرا	negative
عرس	negative
عرص	negative
عرقلت	negative
عره	negative
عروس	positive
عروه	negative
عري	negative
عريان	negative
عريق	positive
عزاء	negative
عزل	negative
عزه	positive
عزو	negative
عزيز	positive
عسر	negative
عسف	negative
عسل	positive
عسير	negative
عشق	positive
عشوائيه	negative
عصابه	negative
عصابي	negative
عصب	negative
عصبى	negative
عصبيه	negative
عصف	negative
عصي	negative
عصيان	negative
عصيانك	negative
عصيب	negative
عطاء	positive
عطل	negative
عظم	positive
عظمتك	negative
عظيم	positive
عفريت	negative
عفن	negative
عفنت	negative
عفه	positive
عفو	positive
عفيف	positive
عقل	positive
عقلاء	positive
عقلاني	positive
عك	negative
عكش	negative
علقه	negative
علي جثتنا	negative
علي جثتي	negative
على عينك يا تاجر	negative
عمي	negative
عميل	negative
عناء	negative
عناد	negative
عنتري	positive
عنجهيه	negative
عندك حق	positive
عنصري	negative
عنصريه	negative
عنف	negative
عنوا	negative
عنيف	negative
عنيفه	negative
عهر	negative
عوالم	negative
عور	negative
عوض	negative
عوضنا على الله	negative
عويل	negative
عياط	negative
عيب	negative
عيبًا	negative
عيد	positive
عيطت	negative
عيل	negative
عين العقل	positive
غار	negative
غاضب	negative
غافل	negative
غالي	positive
غبا	negative
غباء	negative
غباوه	negative
غبائ	negative
غبائك	negative
غبائه	negative
غبي	negative
غتيت	negative
غجر	negative
غدار	negative
غدر	negative
غدرا	negative
غرر	negative
غرف	negative
غرق	negative
غرمان	negative
غرور	negative
غريب	negative
غريم	negative
غش	negative
غشاش	negative
غشك	negative
غصب	negative
غصبا	negative
غضب	negative
غضبك	negative
غفل	negative
غفو	negative
غل	negative
غلاستك	negative
غلب	negative
غلبان	negative
غلبانه	negative
غلس	negative
غلط	negative
غلطان	negative
غلطت	negative
غلطه	negative
غلظ	negative
غلوش	negative
غلول	negative
غم	negative
غمه	negative
غوغاء	negative
غيبو	negative
غيظ	negative
غيظك	negative
فاتت	negative
فاتر	negative
فاجر	negative
فاحش	negative
فاز	positive
فاسد	negative
فاسق	negative
فاشخ	negative
فاشل	negative
فاشي	negative
فاشيه	negative
فاضل	positive
فاضي	negative
فاضيالكو	negative
فاقت	negative
فاكر نفسه ايه	negative
فالح	positive
فايح	negative
فبرك	negative
فتت	negative
فتش	negative
فتن	negative
فتوه	negative
فجر	negative
فجل	negative
فجور	negative
فحش	negative
فخ	negative
فخر	positive
فخفخ	positive
فداء	positive
فرت	negative
فرج	positive
فرح	positive
فرحان	positive
فرحت	positive
فرحتي	positive
فرحه	positive
فرس	negative
فرط	negative
فرعن	negative
فرفر	negative
فرم	negative
فساد	negative
فسادا	negative
فسد	negative
فسدت	negative
فسق	negative
فسل	negative
فشر	negative
فشل	negative
فشلت	negative
فشلتم	negative
فشيخ	negative
فشيق	negative
فصل	negative
فضح	negative
فضحت	negative
فضحتو	negative
فضل	positive
فضيحه	negative
فظ	negative
فظيع	negative
فعال	positive
فقر	negative
فقير	negative
فكك	negative
فككم	negative
فل	positive
فلح	positive
فلس	negative
فله	negative
فلول	negative
فنجري	negative
فهم	positive
فوضوي	negative
فوضي	negative
فوق الشبهات	positive
فوقوا	negative
فياجرا	negative
في الصميم	positive
فى حفظ الله	positive
قابض	negative
قاتل	negative
قادر	positive
قاذورات	negative
قارف	negative
قاس	negative
قاص	negative
قاصي	negative
قاطع	negative
قاع	negative
قباح	negative
قباحه	negative
قبح	negative
قبر	negative
قبض	negative
قبضت	negative
قبيح	negative
قتال	negative
قتل	negative
قتلت	negative
قتلتو	negative
قتلو	negative
قتلي	negative
قتيل	negative
قحاب	negative
قحب	negative
قدر	positive
قدرته	positive
قدوه	positive
قذارتك	negative
قذاره	negative
قذر	negative
قرد	negative
قرص	negative
قرف	negative
قرفو	negative
قرود	negative
قسوه	negative
قصاص	negative
قصر	negative
قصفها	negative
قضائيه	negative
قضايا	negative
قضي	negative
قطع	negative
قطعتو	negative
قفانا	negative
قلب اتحرق	negative
قلة ادب	negative
قلة ادبك	negative
قلش	negative
قلق	negative
قله ادب	negative
قليل الادب	negative
قليله الادب	negative
قمر	positive
قمع	negative
قمعك	negative
قنبله	negative
قنص	negative
قهر	negative
قوا	positive
قوه	positive
قوي	positive
قيد	negative
قيمه	positive
كابس علي نفسنا	negative
كاتم	negative
كادب	negative
كادح	negative
كاذب	negative
كاذبو	negative
كاذبون	negative
كارثه	negative
كاره	negative
كاريزما	positive
كازب	negative
كافر	negative
كان من الاول	negative
كائد	negative
كائدين	negative
كبت	negative
كبرا	negative
كتاكيت	negative
كتاكيتو	negative
كتاويت	negative
كتر خيرك	positive
كتر خيرهم	positive
كتف	negative
كتفو	negative
كحم	negative
كحه	negative
كخه	negative
كداب	negative
كدب	negative
كدبو	negative
كدس	negative
كذااب	negative
كذاب	negative
كذب	negative
كذبا	negative
كذبت	negative
كراما	positive
كرامه	positive
كراهيه	negative
كرب	negative
كرباج	negative
كرم	positive
كره	negative
كرهاك	negative
كرهناك	negative
كرهوا	negative
كرهو 	negative
كريم	positive
كريه	negative
كس	negative
كس امك	negative
كسب	positive
كستك	negative
كسر	negative
كسف	negative
كسك	negative
كسم	negative
كسمك	negative
كسه	negative
كسها	negative
كشر	negative
كشف	negative
كفا	negative
كفاءه	positive
كفار	negative
كفاك	negative
كفائه	positive
كفايه	negative
كفر	negative
كفرو	negative
كفل	positive
كفن	negative
كلااب	negative
كلاب	negative
كلابا	negative
كلاكيع	negative
كلامنجي	negative
كلب	negative
كلمنجي	negative
كلنا مع	positive
كلنا معاك	positive
كلنا معك	positive
كماشه	negative
كمم	negative
كمين	negative
كوابيسك	negative
كوسه	negative
كوميدي	positive
كويس	positive
كئابه	negative
كئيب	negative
كياسه	positive
كيد	negative
لابس	negative
لا حياة لمن تنادى	negative
لاذع	negative
لافض فوك	positive
لامثالك	negative
لامؤاخذ	negative
لا ياشيخ	negative
لايك	positive
لايهمل	negative
لبستو	negative
لبس في الحيطة	negative
لبسنا في الحيطه	negative
لبوه	negative
لتصمت	negative
لجا	negative
لجم	negative
لحس	negative
لذيذ	positive
لزق	negative
لسع	negative
لسه فاكر	negative
لص	negative
لطش	negative
لطم	negative
لطيف	positive
لعان	negative
لعن	negative
لعنه الله علي	negative
لغط	negative
لغو	negative
لغي	negative
لفق	negative
لف ودوران	negative
لقن	positive
للتحريض	negative
للغيظ	negative
للمنافقين	negative
لهب	negative
لهوي	negative
لواط	negative
لوث	negative
لوح	negative
لوطيا	negative
لئيم	negative
لياقه	positive
ليهم عين	negative
مابحبكيش	negative
مابيخدش	positive
مابيعرفوش	negative
مات	negative
مات الكلام	negative
ماتت	negative
ماتربتيش	negative
ماتغور	negative
ماتو	negative
ماتوا	negative
ماجور	negative
مازق	negative
ماساه	negative
ماسخ	negative
ماسوني	negative
ماشاء الله	positive
ما شاء الله	positive
ماطل	negative
ماعندناش	negative
مافقناش	negative
مافيش فايده	negative
مالكيش	negative
مانتخ	negative
مانعرفوش	negative
مايصحش	negative
مايل	negative
ماينفعش	negative
مبتخفش	positive
مبتسم	positive
مبتعرفش	negative
مبتهج	positive
مبدع	positive
مبروك	positive
مبسوط	positive
مبض	negative
مبهج	positive
مت	negative
متاجر	negative
متاخر	negative
متاسلم	negative
متامر	negative
متبلطج	negative
متجاهل	negative
متحامل	negative
متحركوش	negative
متحزم	negative
متحضر	positive
متحول	negative
متخاذل	negative
متخفيش	negative
متخلف	negative
متخلفه	negative
متدين	positive
مترب	negative
مترباش	negative
متزعلش	negative
متزعليش	negative
متزن	positive
متستغلش	negative
متسخ	negative
متسكتش	negative
متسكتيش	negative
متسلق	negative
متسول	negative
متشدد	negative
متشرد	negative
متشرمط	negative
متشيع	negative
متضامن	positive
متضايق	negative
متطرف	negative
متظاهر	negative
متظاهرين	negative
متعاط	negative
متعاطف	positive
متعصب	negative
متعفف	positive
متعقد	negative
متعوس	negative
متغاظ	negative
متفائل	positive
متفجر	negative
متفحش	negative
متفرق	negative
متفهم	positive
متفوق	positive
متقاعس	negative
متقطع	negative
متقطعه	negative
متقلب	negative
متقن	positive
متكبر	negative
متمكن	positive
متملق	negative
متميز	positive
متناك	negative
متناكه	negative
متنفذش	negative
متنيل	negative
متهزئ	negative
متهم	negative
متهما	negative
متهوره	negative
متهيج	negative
متواضع	positive
متواطئ	negative
متوحش	negative
متوكل	positive
متيس	negative
مثقف	positive
مثلي	negative
مجبر	negative
مجتهد	positive
مجحود	negative
مجد	positive
مجدع	positive
مجرم	negative
مجزره	negative
مجنون	negative
مجهول	negative
مجوس	negative
محاصر	negative
محاكمتهم	negative
محال	negative
محايد	positive
محبط	negative
محبه	positive
محبوب	positive
محبوس	negative
محبوسه	negative
محترف	positive
محترمتش	negative
محترمه	positive
محتكر	negative
محتل	negative
محدود	negative
محدود الذكاء	negative
محدوده الذكاء	negative
محدودي الذكاء	negative
محرض	negative
محرف	negative
محروق	negative
محروم	negative
محزق	negative
محسوبيه	negative
محشش	negative
محصلتش	negative
محظور	negative
محظوظ	positive
محكوم	negative
محموق	negative
محن	negative
محنك	positive
مخادع	negative
مخالف	negative
مخب	negative
مخبول	negative
مختطف	negative
مختل	negative
مختل عقليا	negative
مخدر	negative
مخرب	negative
مخز	negative
مخطئ	negative
مخطىء	negative
مخلص	positive
مخلوع	negative
مخمور	negative
مخنوق	negative
مخه صغير	negative
مخيب للامال	negative
مخيف	negative
مداح	positive
مدايق	negative
مدايقه	negative
مدبر	negative
مدلس	negative
مدمر	negative
مدمن	negative
مذبحه	negative
مذهل	positive
مراره	negative
مراوغة 	negative
مراوغه	negative
مربكيش	negative
مربوطين	negative
مرتبك	negative
مرتزق	negative
مرض	negative
مرض اجتماعي	negative
مرعب	negative
مرعوب	negative
مرفوض	negative
مر مرور الكرام	positive
مرمط	negative
مريض	negative
مزاج	negative
مزايد	negative
مزبله التاريخ	negative
مزعج	negative
مزعلكم	negative
مزعلني	negative
مزقوق	negative
مزقوك	negative
مزور	negative
مزيف	negative
مساطيل	negative
مسالم	positive
مسامحينك	positive
مسانده	positive
مساوم	negative
مساومه	negative
مسبش	negative
مستبيع	negative
مستتره	positive
مستحمل	negative
مستحملينك	negative
مستحيل	negative
مستخب	negative
مستسلم	negative
مستغفلا	negative
مستفذ	negative
مستفز	negative
مستفزه	negative
مستمتع	positive
مستميت	negative
مستنسخ	negative
مستنقع	negative
مسجون	negative
مسجونين	negative
مسح	negative
مسخ	negative
مسخر	negative
مسخره	negative
مسرطن	negative
مسرور	positive
مسروق	negative
مسطول	negative
مسعور	negative
مسلح	negative
مسلي	positive
مسمم	negative
مسموم	negative
مسيء	negative
مشاجره	negative
مشاكس	negative
مشاكل	negative
مشانق	negative
مشبوه	negative
مشتمش	negative
مشرف	positive
مش طايق نفسه	negative
مش طايق نفسي	negative
مشعوذ	negative
مش عيب عليك	negative
مش عيب عليكم	negative
مش فاهم حاجه	negative
مش كفايه	negative
مشكل	negative
مشكلته	negative
مشكله	negative
مش ناقصاك	negative
مش ناقصه	negative
مشوق	positive
مشوه	negative
مشين	negative
مصاب	negative
مصارحته	positive
مصايب	negative
مصتبح	negative
مصرع	negative
مصطنع	negative
مصون	positive
مصيب	negative
مصيبه	negative
مضاد	negative
مضحك	positive
مضروب	negative
مضطرب	negative
مضلل	negative
مضيق	negative
مطبلاتي	negative
مطحون	negative
مطرودا	negative
مطعون	negative
مطمع	negative
مطمئن	positive
مطوه	negative
مطيع	positive
مظالم	negative
مظاهراتهم	negative
مظاهرة	negative
مظبوط	positive
مظلمه	negative
مظلوم	negative
معاد	negative
معاداتك	negative
معارضه	negative
معارضيهم	negative
معاق	negative
معاك حق	positive
معاناه	negative
معاند	negative
معتد	negative
معتقل	negative
معتقلين	negative
معتوه	negative
معجب	positive
معجبيك	positive
معدوم	negative
معرس	negative
معرص	negative
معركه	negative
معزول	negative
معشوق	negative
معصوم	negative
معصيه	negative
معفن	negative
معقد	negative
معك حق	positive
معلش	negative
معناة	negative
معندكش دم	negative
معندكيش دم	negative
معندهاش دم	negative
معندهمش	negative
معندهمش دم	negative
معندهوش دم	negative
معندهومش دم	negative
معندوش دم	negative
معوق	negative
معيب	negative
مغالط	negative
مغتاب	negative
مغتصب	negative
مغرر	negative
مغرض	negative
مغرور	negative
مغشوش	negative
مغفل	negative
مغلوط	negative
مغيب	negative
مفتت	negative
مفتر	negative
مفتري	negative
مفتريه	negative
مفتريين	negative
مفجوع	negative
مفرط	negative
مفسد	negative
مفشوخ	negative
مفضوح	negative
مفهمش	negative
مفيد	positive
مفيش فايده	negative
مقاوم	negative
مقبولا	positive
مقتك	negative
مقتل	negative
مقرف	negative
مقزز	negative
مقشف	negative
مقطف	negative
مقلب	negative
مقلبظ	negative
مقموص	negative
مقهور	negative
مقيد	negative
مكبوت	negative
مكتف	negative
مكذوب	negative
مكر	negative
مكرو	negative
مكروب	negative
مكروه	negative
مكسوف	negative
مكشر	negative
ملاك	positive
ملاوع	negative
ملاوعه	negative
ملثم	negative
ملحد	negative
ملزق	negative
ملط	negative
ملطش	negative
ملعلع	positive
ملعوب	negative
ملعون	negative
ملل	negative
ملوث	negative
ممتاز	positive
ممتازه	positive
ممتع	positive
ممسح	negative
ممل	negative
ممول	negative
مموه	negative
مميت	negative
مميز	positive
مناخير	negative
مناضل	positive
منافق	negative
منافقيك	negative
منايك	negative
منتحر	negative
منتفع	negative
منتهك	negative
منحرف	negative
من حسن الحظ	positive
منحط	negative
منحل	negative
منحوس	negative
منخليش	negative
مندبه	negative
مندس	negative
منشق	negative
منصف	positive
منصور باذن الله	positive
منطقي	positive
منع	negative
منعش	positive
منفر	negative
منفصم	negative
منفعل	negative
منفلت	negative
منقذ	positive
منقوص	negative
منكر	negative
منك لله	negative
منكم لله	negative
منهار	negative
منها لله	negative
منه لله	negative
منهم لله	negative
منهوب	negative
منور	positive
منوم	negative
منيح	positive
منيل	negative
منيوك	negative
مهابيل	negative
مهاجم	negative
مهانه	negative
مهبوش	negative
مهبول	negative
مهتوك	negative
مهدر	negative
مهدود	negative
مهذب	positive
مهزء	negative
مهزا	negative
مهزل	negative
مهل	negative
مهمش	negative
مهنج	negative
مهين	negative
مؤامر	negative
مؤامره	negative
موت	negative
موت بغيظك	negative
موتوا بغيظكم	negative
مؤثر	positive
موحوح	negative
مؤخر	negative
مؤدب	positive
موده	positive
مؤذ	negative
موسخ	negative
موضوعي	positive
موفق	positive
موفق بأذن الله	positive
موفقين بأذن الله	positive
موقوف	negative
موكوس	negative
مولتوف	negative
مؤلم	negative
مولوتوف	negative
مومس	negative
مؤمن	positive
موه	negative
موهوم	negative
مؤيد	positive
ميحسش	negative
ميزه	positive
ميلزمنيش	negative
نابغ	positive
ناجح	positive
ناجحه	positive
ناخب	negative
ناخدك	negative
نارك	negative
ناصر	positive
ناضل	positive
نامي	positive
ناهب	negative
نايب	negative
نايكاك	negative
نباح	negative
نبارك	positive
نبح	negative
نبذ	negative
نبرع	positive
نبسط	positive
نبضن	negative
نبطل	negative
نبك	negative
نبكي	negative
نبل	positive
نتجاهل	negative
نتحبس	negative
نتحرق	negative
نتخاذل	negative
نتخاصم	negative
نتخانق	negative
نتخرس	negative
نتخزوق	negative
نتخض	negative
نتخطف	negative
نتخلي	negative
نتدخل	negative
نتراجع	negative
نتربي	negative
نترحم	negative
نتردد	negative
نتريق	negative
نتسجن	negative
نتسول	negative
نتش	negative
نتشتم	negative
نتشرد	negative
نتشل	negative
نتشلح	negative
نتصاب	negative
نتطاول	negative
نتظاهر	negative
نتظلم	negative
نتعارض	negative
نتعدم	negative
نتعذب	negative
نتعرض	negative
نتعقب	negative
نتفق	positive
نتكتم	negative
نتكسف	negative
نتلم	negative
نتمسح	negative
نتن	negative
نتناقض	negative
نتناك	negative
نتنح	negative
نتنفخ	negative
نتنكر	negative
نتهان	negative
نتهد	negative
نتهم	negative
نتوب	negative
نتوكس	negative
نثق	positive
نجاح	positive
نجاحك	positive
نجادل	negative
نجاس	negative
نجتهد	positive
نجح	positive
نجد	negative
نجرح	negative
نجرو	negative
نجسس	negative
نجوع	negative
نحارب	negative
نحاسب	negative
نحاكم	negative
نحاكمك	negative
نحبس	negative
نحبك	positive
نحبوك	positive
نحتج	negative
نحترق	negative
نحترم	positive
نحتفل	positive
نحتقر	negative
نحذر	negative
نحرسك	positive
نحرق	negative
نحرمو	negative
نحزن	negative
نحس	negative
نحسد	negative
نحشر	negative
نحطم	negative
نحفز	positive
نحفظك	positive
نحمي	positive
نحميك	positive
نحي	positive
نحيا	positive
نحيتك	negative
نحيك	positive
نحيه	positive
نخاف	negative
نخالف	negative
نخب	negative
نخبط	negative
نخجل	negative
نخدع	negative
نخذلكم	negative
نخرس	negative
نخرص	negative
نخريب	negative
نخز	negative
نخسر	negative
نخشي	negative
نخطء	negative
نخطئ	negative
نخلص	negative
نخلف	negative
نخوف	negative
نخون	negative
نخوه	positive
نخيف	negative
ندافع	negative
ندام	negative
ندبحو	negative
ندد	negative
ندعم	positive
ندعمه	negative
ندعي	negative
ندم	negative
نذبح	negative
نربح	positive
نربي	positive
نربيك	negative
نرتاح	positive
نرتجف	negative
نرحب	positive
نرحل	negative
نرحم	positive
نرحمك	positive
نرحمه	positive
نردح	negative
نرعب	negative
نرفض	negative
نركب	negative
نركبك	negative
نرن	negative
نريح	negative
نريحك	positive
نريق	negative
نزاهه	positive
نزايد	negative
نزرط	negative
نزع	negative
نزعلك	negative
نزعلو	negative
نزف	negative
نزلزل	negative
نزهق	negative
نزوغ	negative
نزيح	negative
نزيط	negative
نزيه	positive
نسامح	positive
نسب	negative
نستبعد	negative
نستجعل	negative
نستحي	positive
نستخف	negative
نستدرج	negative
نستغفر	positive
نستغل	negative
نستغيث	negative
نستفيد	positive
نستقر	positive
نستلم	negative
نستنجد	negative
نسجن	negative
نسخر	negative
نسرق	negative
نسعدك	positive
نسف	negative
نسفك	negative
نسفل	negative
نسقط	negative
نسون	negative
نسي	negative
نسيئ	negative
نشاور	positive
نشتت	negative
نشتمو	negative
نشجب	negative
نشد	negative
نشدد	negative
نشعل	negative
نشكر	positive
نشكرك	positive
نشل	negative
نشوه	negative
نشيع	negative
نشيل	negative
نصب	negative
نصبر	negative
نصتدم	negative
نصدق	positive
نصر	positive
نصرخ	negative
نصلح	positive
نصمت	negative
نصيح	negative
نضحك	positive
نضر	negative
نضرب	negative
نضربك	negative
نضطر	negative
نضعف	negative
نضيع	negative
نضيف	positive
نضييع	negative
نطعن	negative
نطغ	negative
نطغي	negative
نطمئن	positive
نطهر	negative
نظف	positive
نظلم	negative
نظيف	positive
نعاج	negative
نعارض	negative
نعاقب	negative
نعاقبه	negative
نعترض	negative
نعترف	negative
نعتقل	negative
نعدم	negative
نعذب	negative
نعر	negative
نعرص	negative
نعري	negative
نعريك	negative
نعزل	negative
نعصب	negative
نعصي	negative
نعفو	positive
نعور	negative
نغتصب	negative
نغرق	negative
نغش	negative
نغضب	negative
نغلط	negative
نغور	negative
نفاقك	negative
نفت	negative
نفتت	negative
نفتخر	positive
نفتر	negative
نفتقد	positive
نفتن	negative
نفديك	positive
نفر	negative
نفسد	negative
نفسنه	negative
نفشخك	negative
نفشل	negative
نفضح	negative
نفضحك	negative
نفع	positive
نفلح	positive
نفلس	negative
نفهم	positive
نفهمك	positive
نفيس	positive
نقاضي	negative
نقاوم	negative
نقبض	negative
نقبل	positive
نقتحم	negative
نقتص	negative
نقتل	negative
نقتلك	negative
نقتلو	negative
نقد	negative
نقدرك	positive
نقرف	negative
نقص	negative
نقصر	negative
نقض	negative
نقضي	negative
نقط	negative
نقع	negative
نقي	positive
نقيل	negative
نكايه	negative
نكتم	negative
نكد	negative
نكدب	negative
نكدس	negative
نكذبو	negative
نكرم	positive
نكرمك	positive
نكرمه	positive
نكره	negative
نكرهك	negative
نكسب	positive
نكسر	negative
نكسرو	negative
نكسف	negative
نكشف	negative
نكفر	negative
نكفل	positive
نلتزم	positive
نلجا	negative
نلطش	negative
نلعن	negative
نلعنك	negative
نلم	negative
نليف	negative
نماطل	negative
نمسخرك	negative
نمنع	negative
نمهل	negative
نميمه	negative
ننافق	negative
ننبح	negative
ننتحر	negative
ننتحل	negative
ننتصر	positive
ننتقد	negative
ننتقم	negative
ننتهي	negative
ننجح	positive
ننزف	negative
ننس	negative
ننسحب	negative
ننصر	positive
ننصره	positive
ننصرهم	positive
ننضرب	negative
ننفخ	negative
ننفضح	negative
ننكر	negative
ننكرها	negative
ننهش	negative
ننهض	positive
ننيكك	negative
نهاجم	negative
نهار اسود	negative
نهاركم اسود	negative
نهارك مش فايت	negative
نهتك	negative
نهد	negative
نهدد	negative
نهدر	negative
نهدم	negative
نهرب	negative
نهرتل	negative
نهزئ	negative
نهش	negative
نهض	positive
نهمل	negative
نهنئ	positive
نهيج	negative
نهين	negative
نواح	negative
نوافق	positive
نوجع	negative
نور	positive
نوفقك	positive
نولع	negative
نولول	negative
نؤيد	positive
نيمين	negative
هابط	negative
هابل	negative
هاجم	negative
هاجمو	negative
هادف	positive
هادئ	positive
هارب	negative
هاشتمك	negative
هان	negative
هايطلق	negative
هايف	negative
هايل	positive
هبط	negative
هبل	negative
هبله	negative
هبوط	negative
هتتاجل	negative
هتتحسب	negative
هتتضرب	negative
هتخربو	negative
هتزعل	negative
هتش	negative
هتشتغل	negative
هتشتم	negative
هتضيع	negative
هتقع	negative
هتك	negative
هتموت	negative
هتوحشنا	negative
هتولع	negative
هجايص	negative
هجر	negative
هجس	negative
هجص	negative
هجم	negative
هجوم	negative
هدام	negative
هدد	negative
هددني	negative
هدر	negative
هدم	negative
هذيان	negative
هرب	negative
هربان	negative
هربت	negative
هربو	negative
هربوا	negative
هرتل	negative
هرتله	negative
هرجل	negative
هرول	negative
هري	negative
هزء	negative
هزأ	negative
هزا	negative
هزار	negative
هزق	negative
هزل	negative
هزم	negative
هزيمه	negative
هسهس	negative
هشتم	negative
هضيع	negative
هطق	negative
هطل	negative
هلاك	negative
هلس	negative
هلفطه	negative
هلك	negative
همج	negative
همجي	negative
همد	negative
همه	positive
هموت	negative
همومك	negative
هنحل	positive
هنشتم	negative
هنفشل	negative
هنكدب	negative
هننفخك	negative
هنئ	positive
هنيكك	negative
هوان	negative
هواهم	negative
هوج	negative
هو ده الشغل	positive
هياف	negative
‎هيب	positive
هيتناك	negative
هيج	negative
هيجان	negative
هيحاسبك	negative
هيخسر	negative
هيربيك	negative
هيرحمنا	negative
هيسحب	negative
هيسقط	negative
هيص	negative
هيصه	negative
هيضرب	negative
هيضيعو	negative
هيعبرك	negative
هيقتل	negative
هيمن	negative
هي ناقصه	negative
هيندم	negative
هينيكك	negative
هيهرب	negative
هييس	negative
واسطه	negative
واضح	positive
واطي	negative
واعي	positive
واهم	negative
وبلاغات	negative
وتحريض	negative
وجع	negative
وحشيه	negative
ود	positive
ورط	negative
ورع	positive
ورعه	positive
وساخه	negative
وساخه‬‏  	negative
وسخ	negative
وسطيه	positive
وسوس	negative
وشكاوي	negative
وضاعه	negative
وضح	positive
وطني	positive
وفاء	positive
وفق	positive
وقاحه	negative
وقح	negative
وكس	negative
وكسه	negative
ولاد مره	negative
ولاد وسخه	negative
ولع	negative
ولعه	negative
ولول	negative
ومظاهرات	negative
وممتاز	positive
وهل	negative
وهم	negative
ويضحك	positive
يا خبر اسود	negative
ياخدك	negative
يا روح امك	negative
يا روح اومك	negative
يا روح خالتك	negative
يا روح طنط	negative
ياس	negative
ياكش تولع	negative
ياكش يولعوا	negative
ياكلاب	negative
يالهوي	negative
يا لهوي	negative
يامنافقين	negative
يانهار اسود	negative
يا نهار اسود	negative
يانهر اسود	negative
ياهب	negative
يائس	negative
يبارك	positive
يبتسم	positive
يبتهج	positive
يبدع	positive
يبذ	negative
يبضن	negative
يبطل	negative
يبكي من الفرح	positive
يبيح	negative
يتبرا	negative
يتبرؤن	negative
يتبعزق	negative
يتجاهل	negative
يتحبس	negative
يتحبسوا	negative
يتحرق	negative
يتحسر	negative
يتحشر	negative
يتحملك	positive
يتخاذل	negative
يتخاصم	negative
يتخرس	negative
يتخزوق	negative
يتخض	negative
يتخلي	negative
يتخمد	negative
يتدخل	negative
يتراجع	negative
يتربي	negative
يترحم	negative
يتردد	negative
يتركوا	negative
يتسجن	negative
يتسحل	negative
يتسلح	negative
يتسول	negative
يتشرد	negative
يتشل	negative
يتشلح	negative
يتصاب	negative
يتطاول	negative
يتظاهر	negative
يتظاهرون	negative
يتظلم	negative
يتعارض	negative
يتعر	negative
يتعرض	negative
يتعظوا	negative
يتعقب	negative
يتف	negative
يتفرس	negative
يتفنن	negative
يتقبض	negative
يتقتلو	negative
يتقمص	negative
يتقن	positive
يتكتم	negative
يتكسف	negative
يتلسع	negative
يتلم	negative
يتمسح	negative
يتناك	negative
يتنح	negative
يتنفخ	negative
يتنكر	negative
يتنيل	negative
يتهد	negative
يتهدد	negative
يتهم	negative
يتواطا	negative
يتوب	negative
يتورطوا	negative
يتوكس	negative
يثق	positive
يجادل	negative
يجاملك	positive
يجبر	negative
يجتهد	positive
يجحم	negative
يجرح	negative
يجرو	negative
يجنن	negative
يجوع	negative
يحارب	negative
يحاسب	negative
يحاصر	negative
يحاكمك	negative
يحالف	positive
يحبس	negative
يحبط	negative
يحبك	positive
يحبوك	positive
يحتج	negative
يحترف	positive
يحترق	negative
يحترم	positive
يحتفل	positive
يحتقر	negative
يحتل	negative
يحذر	negative
يحرسك	positive
يحرصك	positive
يحرم	negative
يحرمنا	negative
يحرمو	negative
يحزن	negative
يحسد	negative
يحشر	negative
يحطم	negative
يحظك	positive
يحفز	positive
يحفظ	positive
يحفظك	positive
يحك	negative
يحمي	positive
يحميك	positive
يحن	positive
يحيا	positive
يحيك	positive
يحيه	positive
يخاف	negative
يخبط	negative
يخترع	positive
يخترق	negative
يخجل	negative
يخدر	negative
يخدع	negative
يخدك	negative
يخذلكم	negative
يخرب بيتك	negative
يخرب بيوتكم	negative
يخربيت	negative
يخرس	negative
يخرص	negative
يخز	negative
يخسر	negative
يخش	negative
يخشي	negative
يخطء	negative
يخطيء	negative
يخطئ	negative
يخلص	negative
يخلصكم	negative
يخلف	negative
يخليك	positive
يخو	negative
يخوف	negative
يخونو	negative
يخيف	negative
يدافع	negative
يدبحوا	negative
يدعم	positive
يدعمك	positive
يدعمه	positive
يدعي	negative
يدمر	negative
يدمن	negative
يدهس	negative
يذبح	negative
يراق	negative
يربح	positive
يربوك	negative
يربيك	negative
يرتاح	positive
يرتجف	negative
يرحب	positive
يرحل	negative
يرحم	positive
يرحمك	positive
يرحمه	positive
يردح	negative
يرشد	positive
يرفض	negative
يركب	negative
يركع	negative
يرموك	negative
يرن	negative
يريح	negative
يريحك	positive
يريق	negative
يزايد	negative
يزرط	negative
يزعل	negative
يزعلك	negative
يزكوا	positive
يزهق	negative
يزوغ	negative
يزيح	negative
يزيط	negative
يسامح	positive
يسب	negative
يستاهلوا	negative
يستبعد	negative
يستبيح	negative
يستبيحو	negative
يستجعل	negative
يستحمل	negative
يستحي	positive
يستخف	negative
يستدرج	negative
يستسلم	negative
يستغفر	positive
يستغيث	negative
يستفيد	positive
يستقر	positive
يستلم	negative
يستنجد	negative
يستنزف	negative
يستنكرون	negative
يستهتر	negative
يستهزء	negative
يسجن	negative
يسجنو	negative
يسحلونك	negative
يسخن	negative
يسعد	positive
يسعدك	positive
يسعدنا	positive
يسفك	negative
يسفل	negative
يسقطو	negative
يسقط يسقط	negative
يسلم فمك	positive
يسلم فومك	positive
يسهم	positive
يسيئ	negative
يشتت	negative
يشتمو	negative
يشدد	negative
يشرف	positive
يشعل	negative
يشفيك	positive
يشكر	positive
يشكرك	positive
يشكم	negative
يشوه	negative
يشوهو	negative
يشيد	positive
يشيع	negative
يشيل	negative
يصاب	negative
يصبر	negative
يصبرك	positive
يصتدم	negative
يصح	positive
يصد	positive
يصدق	positive
يصفع	negative
يصلح	positive
يصمت	negative
يصون	positive
يصيب	negative
يصيح	negative
يصيع	negative
يضحك	positive
يضحك علينا	negative
يضحكوا علينا	negative
يضر	negative
يضربك	negative
يضطر	negative
يضعف	negative
يضللو	negative
يضيع	negative
يضييع	negative
يطعن	negative
يطغي	negative
يطمئن	positive
يطهر	positive
يظلم	negative
يعارض	negative
يعاقب	negative
يعاقبه	negative
يعتدوا	negative
يعتذر	positive
يعترض	negative
يعترف	negative
يعتقل	negative
يعتقلو	negative
يعجبن	positive
يعجبني	positive
يعدم	negative
يعذبو	negative
يعرص	negative
يعري	negative
يعريك	negative
يعزك	positive
يعزل	negative
يعزلوا	negative
يعشق	positive
يعصي	negative
يعط	negative
يعظ	negative
يعفو	positive
يعقل	positive
يعني ايه	negative
يعور	negative
يعورو	negative
يعيش	positive
يعيق	negative
يغصبن	negative
يغضب	negative
يغلط	negative
يغيب	negative
يفتت	negative
يفتر	negative
يفتري	negative
يفتقد	positive
يفتي	negative
يفديك	positive
يفر	negative
يفرح	positive
يفسد	negative
يفشخ	negative
يفشخك	negative
يفشل	negative
يفضحك	negative
يفلح	positive
يفهمك	positive
يفيد	positive
يقاضي	negative
يقبض	negative
يقبل	positive
يقتحم	negative
يقتص	negative
يقتلك	negative
يقتلو	negative
يقحم	negative
يقدرك	positive
يقضي	negative
يقع	negative
يقلعوك	negative
يقمع	negative
يقويكي	positive
يقيل	negative
يكتم	negative
يكحمك	positive
يكدس	negative
يكذبو	negative
يكر	negative
يكرم	positive
يكرمك	positive
يكرمه	positive
يكره	negative
يكرهك	negative
يكسب	positive
يكسرو	negative
يكشف	negative
يكفر	negative
يكفل	positive
يكوش	negative
يلتزم	positive
يلجمك	negative
يلزقو	negative
يلعن	negative
يلعن ابو	negative
يلعن سلسفيل	negative
يلم	negative
يليف	negative
يماطل	negative
يمسخرك	negative
يمكر	negative
يمكرالله	negative
يمنع	negative
يمهل و لا يهمل	negative
يموت	negative
يناقض	negative
ينبح	negative
ينتحر	negative
ينتحل	negative
ينتصر	positive
ينتقد	negative
ينتقم	negative
ينتن	negative
ينتهي	negative
ينجح	positive
ينحني	negative
ينخرس	negative
يندد	negative
ينرفز	negative
ينرفزن	negative
ينزع	negative
ينزف	negative
ينسا	negative
ينسحب	negative
ينسو	negative
ينصر	positive
ينصرك	positive
ينصره	positive
ينصرهم	positive
ينصف	positive
ينضرب	negative
ينعم	positive
ينفخ	negative
ينفضح	negative
ينقذ	positive
ينقط	negative
ينكر	negative
ينكران	negative
ينكرها	negative
ينهبو	negative
ينهزم	negative
ينهش	negative
ينهض	positive
ينور	positive
ينييكك	negative
يهاجم	negative
يهان	negative
يهب	negative
يهتك	negative
يهد	negative
يهدر	negative
يهدي	positive
يهديك	positive
يهرب	negative
يهزيء	negative
يهزئ	negative
يهش	negative
يهمل	negative
يهنئ	positive
يهيص	negative
يوافق	positive
يؤتمن	positive
يوجع	negative
يورط	negative
يوري	negative
يوفقك	positive
يولع	negative
يولعو	negative
يولول	negative
يؤمن	positive
يؤيد	positive
انتقام	negative
